XXXXXXXXXX
X........X
X........X
X.I......X
X........X
X........X
XI.......X
X........X
X........X
X........X
X........X
XH....I..X
X........X
XXXXXXXXXX
